maze = [
    ["S"," ","#"," ","#"," "," ","#"," "," "," ","#"," "," "," "],
    ["#"," ","#"," ","#"," ","#"," ","#","#"," ","#"," ","#"," "],
    ["#"," "," "," "," "," ","#"," "," "," "," ","#"," ","#"," "],
    ["#","#","#","#","#"," ","#","#","#","#"," ","#"," ","#"," "],
    ["#"," "," "," ","#"," "," "," ","#","#"," ","#"," "," "," "],
    ["#"," ","#"," ","#","#","#"," ","#"," "," ","#","#","#"," "],
    ["#"," ","#"," "," "," ","#"," ","#"," ","#"," "," "," "," "],
    ["#"," ","#","#","#"," ","#"," ","#"," ","#"," ","#","#"," "],
    ["#"," "," "," ","#"," "," "," ","#"," "," "," ","#"," ","E"],
    ["#","#","#"," ","#","#","#","#","#","#","#","#","#","#","#"]
]